#英文	中文	[不使用的翻译|]备注，如果不包含 | 则只会提示，不会替换
operator	运算符
statements	语句	声明,陈述|
remove	移除	删除|
delete	删除	两者好像没有区别,但还是根据不同的单词进行不同的翻译
cursor	光标	游标|
caret	插入符	光标|与光标区分开
change	更改,变更	改变|如果名词性不强,就使用“变更”
all	全部,所有,全	
live template	代码模板
complete	补全,完整,完成,完全
code complete	代码补全
Popup Menu	弹出菜单
action	操作,动作
parentheses	括号,小括号,圆括号
brackets,square brackets	括号,中括号,方括号
braces,curly braces	括号,大括号,花括号
angle brackets	尖括号
period	句号
comma	逗号
semicolon	分号
asterisk	星号
i18n,internationalization	国际化
L10n,localization	本地化
Soft Wraps	自动换行
super	超,super
parent	父	两者应该没区别
evaluated	计算,解析	评估|常用于调试部分,如计算表达式,无法解析字段
expected	预期,期望	如期望一个布尔值
Productivity Features Guide	生产力功能指南	就是统计你使用了哪些功能有助于提高你工作效率
occurrence	匹配项	出现|有时也被翻译为出现,表示查找结果的匹配项
pattern	模式	就是正则、字符串模式,不好翻译
root	根	如git的根目录,项目根目录
argument	参数,实参
parameter	参数,形参	应该是混用的,只是在代码样式→换行和括号中补区分
formal and actual parameters	形参和实参
reference	引用,参考
scratch	临时文件,草稿,临时	不会列入项目中
Instant Run	即时运行
variant	变体
repository	仓库	存储库,版本库|git 中统一翻译

# 一些临时的
class	类	课程,班级|
primitive	基本	原始,基元,原语|
field	字段	领域|
highlighted	高亮	突出显示|
excerpt	片段	摘录|
interface	接口	界面|
retrieve	获取	检索|
implement	实现	实施|
override	覆盖	重写|
box	装箱	打包|
unbox	拆箱	解包|
#exception	异常	例外|
native	原生	本地|
token	语素	令牌|
process	进程	过程
executor	执行器	执行程序|
idiom	习惯用法	习语,成语,习惯用语|
unchecked exception	非检查型异常	未经检查的异常,未选中的异常|
checked exception	检查型异常	经检查的异常,已检查的异常,选中的异常|
reluctant	懒惰	不情愿|
sign	签名	签署|

# 集体相关
collection	集合	收藏品,收藏|
reduction	缩减	还原,减少|
parallel	并行	并发,平行|
concurrent	并发	并行|
ad hoc	特设	特殊,临时|
literal	字面量	文字|
#quote	引语	引用,引号,报价|用于数据报中的示例
trail	路径	小路,小道,小径,线索,跟踪|

# 泛型相关
cast	强制转换	演员|
lower bounded	下界	下限有界,下限|
upper bounded	上界	上限有界,上限|
#generic	泛型	通用,仿制药|只在泛型相关部分使用，其余还是使用“通用”

# 国际化相关
program	程序	计划|
end user	终端用户	最终用户|
locale	区域设置	语言环境|
tag	标签	标记|
key	键	密钥
message	消息	邮件|
sample	示例	样本,样品|
collation	排序	归类,整理|
supplementary	补充	增补|也译为辅助字符
character	字符	角色|
word	单词	文字,字|临时使用
line	行	线|
shaper	形状器	整形器|
listener	监听器	侦听器|
palette	面板	调色板|

# 反射相关
reflect	反射	反思|
annotation	注解	注释|
extends	继承	扩展
formal parameter	形式参数	正式参数|
variable arity	可变数量的	可变的 arity,变量 arity|可变参数或者可变数量的参数
array	数组	阵列|
identify	识别	标识|
reference type	引用类型	参考类型|
primitive type	基本类型

# 扩展
installed extension	安装型扩展	已安装的扩展,安装的扩展,已安装扩展|
download extension	下载型扩展	下载的扩展,下载扩展|
header	头	标头|
extension	扩展	扩展名|
provider	提供者	提供程序,提供商|

# 全屏独占
active rendering	主动渲染	活动渲染|
full-screen exclusive	全屏独占	
monitor	显示器	监视器|
robust	健壮	鲁棒,强大|
graphics card	显卡	图形卡|
